**********
*        *
* P      *
* ****   *
*        *
*        *
*  P     *
*  ***   *
*     P  *
**********
